glance
decent 

whether 
stale 
shift 
draft 
outline 
stash

-----> 04/03/2019

increasingly = more and more -> de plus en plus
stale = ~ périmée 
devise = concevoir, inventer ...
scattered = éparpillé
encounter = unexpectedly experience or be faced with (something difficult or hostile)
discard = a person or thing rejected as no longer useful or desirable. -> jeter, se débarrasser, écarter
steady = stable, régulier,constant
come up with = touver une solution, avoir une idée
FYI = For Your Information
fellow = sharing a particular activity, quality, or condition with someone or something. -> collègue, compagnon || a man or boy
pace = rythme, allure, vitesse
stash = a secret store of something -> planque, mettre à l’abri, cacher
overlay = covering
showcase = exhibit, display => exposer ou presenter en vitrine
stumble = trip or momentarily lose one's balance; almost fall. => trébucher
workaround = solution de contournement
for recall = pour rappel
actually = en fait ...
overwhelmed = bury or drown beneath a huge mass. => submergé
sweeping = clean (an area) by brushing away dirt or litter.
rug = a floor covering of thick woven material or animal skin, typically not extending over the entire floor.
As a matter of fact = À vrai dire, en fait
mainstream = the ideas, attitudes, or activities that are regarded as normal or conventional; 
                the dominant trend in opinion, fashion, or the arts.
nowadays = at the present time, in contrast with the past.
nagging = (of a person) constantly harassing someone to do something.
grasp = prise, poigne, comprehension
recipes = recette 
recipient  = a person or thing that receives or is awarded something.
flicker = ...rapid variations
takeaway = a key fact, point, or idea to be remembered, typically one emerging from a discussion or meeting.
hatche = an opening of restricted size allowing for passage from one area to another, in particular.
conspire to devise (a plot or plan).
clumsy = awkward in movement or in handling things. maladroit
Swimming Against the Tide
emphasis = special importance, value, or prominence given to something. -> accentuation
aim = objective, gaol, target, intent
tradeoffs = compromis
disclaimer = avertissement  
overall = global
Regardless = بغض النظر
flaw = defaut, imperfection
relevant = pertinent, approprié
sluggish = slow-moving or inactive.
fold =  الطية، يطوي
throttle = étrangler, accélérateur 
eager = impatient, pressé, enthousiaste
silly = idiot, stupid ...
brag = se vanter
